##############################
#@                           #
#                            #
#                            #
#        *                   #
#                            #
#                            #
#         *                  #
#                            #
#                            #
#             *              #
#                            #
#     *                      #
#                            #
#                            #
#                            #
#                            #
#                            #
#                            #
##############################
